iaghomyazum	I
tuhkas	you
isiaya	he
weykitmes	we
ikamyuasvi	youall
eyesid	they
kosasni	this
itsotas	that
kiseisidin	here
hentam	there
kwisimkit	who
kwisnankitcit	what
kwesnukud	where
kadkogyan	when
kug	how
nedi	not
qamwisvic	all
mondou	many
kelnekay	some
pehmal	few
heldrukidum	other
hoyedsan	one
dwohsdiv	two
treytel	three
kwetcatsapket	four
penlimpet	five
